22
90
16 0 0 0 0 0 0 0 0 0 0 0 0 0 0 0 0 0 0 0 0 16 
16 0 0 0 0 0 0 0 0 0 0 0 0 0 0 0 0 0 0 0 0 16 
16 0 0 0 0 0 0 0 0 0 0 0 0 0 0 0 0 0 0 0 0 16 
16 0 0 0 0 0 0 0 0 0 0 0 0 0 0 0 0 0 0 0 0 16 
16 0 0 0 0 0 0 0 0 0 0 0 0 0 0 0 0 0 0 0 0 16 
16 0 0 0 0 0 0 0 0 0 0 0 0 0 0 0 0 0 0 0 0 16 
16 0 0 0 0 0 0 0 0 0 0 0 0 0 0 0 0 0 0 0 0 16 
16 0 0 0 0 0 0 0 0 0 0 0 0 0 0 0 0 0 0 0 0 16 
15 15 15 17 17 17 17 17 17 17 17 17 17 0 0 0 0 16 16 16 16 16 
15 15 15 0 0 0 0 0 0 0 0 0 0 0 0 0 0 16 16 16 16 16 
15 15 15 0 0 0 0 0 0 0 0 0 0 0 0 0 0 16 16 16 16 16 
15 15 15 0 0 0 0 0 0 0 0 0 0 0 0 17 17 16 16 16 16 16 
15 15 15 0 0 0 0 0 0 0 0 0 0 0 0 0 0 16 16 16 16 16 
15 15 15 0 0 0 0 0 0 0 0 0 0 0 0 0 0 16 16 16 16 16 
15 15 15 0 0 0 0 0 0 0 0 0 0 0 0 0 0 16 16 16 16 16 
15 15 15 0 0 0 10 0 0 10 0 10 0 0 10 0 0 16 16 16 16 16 
15 15 15 10 0 0 0 0 0 0 0 10 10 10 10 0 0 16 16 16 16 16 
15 15 15 10 0 0 0 0 0 0 0 0 0 0 0 0 0 16 16 16 16 16 
15 15 15 10 10 0 0 0 0 0 0 0 0 0 0 0 0 16 16 16 16 16 
15 15 15 10 10 0 0 0 0 0 0 0 0 0 0 0 0 16 16 16 16 16 
15 15 15 10 10 10 0 10 10 0 10 10 10 10 10 0 0 16 16 16 16 16 
15 15 15 0 0 0 0 0 0 0 0 0 0 0 0 0 0 16 16 16 16 16 
15 15 15 0 0 0 0 0 0 0 0 0 0 0 0 0 0 16 16 16 16 16 
15 15 15 0 0 0 0 0 0 0 0 0 0 0 0 0 0 16 16 16 16 16 
15 15 15 0 0 0 0 0 0 0 0 0 0 0 0 0 10 16 16 16 16 16 
15 15 15 0 0 0 0 0 0 0 0 10 0 0 0 0 0 16 16 16 16 16 
15 15 15 0 0 0 0 10 10 10 0 0 0 10 10 10 0 16 16 16 16 16 
15 15 15 0 0 0 0 0 0 0 0 0 0 0 0 0 0 16 16 16 16 16 
15 15 15 0 0 0 0 0 0 0 0 0 0 0 0 0 0 16 16 16 16 16 
15 15 15 0 0 0 0 0 0 0 0 0 0 0 0 0 0 16 16 16 16 16 
15 15 15 10 0 0 0 0 0 0 0 0 0 0 0 0 0 16 16 16 16 16 
15 15 15 0 0 0 0 0 0 0 0 0 0 0 0 0 0 16 16 16 16 16 
15 15 15 0 0 0 10 0 0 10 0 10 0 0 10 0 0 16 16 16 16 16 
15 15 15 0 10 0 10 10 10 10 0 10 10 10 10 0 0 16 16 16 16 16 
15 15 15 0 0 0 0 0 0 0 0 0 0 0 0 0 10 16 16 16 16 16 
15 15 15 0 0 0 0 0 0 0 0 0 0 0 0 0 0 16 16 16 16 16 
15 15 15 0 0 0 0 0 0 0 0 0 0 0 0 10 0 16 16 16 16 16 
15 15 15 0 0 0 0 0 0 0 0 0 0 0 0 0 0 16 16 16 16 16 
15 15 15 0 0 0 0 0 0 0 0 0 0 0 10 0 0 16 16 16 16 16 
15 15 15 0 0 0 0 0 0 0 0 0 0 0 0 0 0 16 16 16 16 16 
15 15 15 0 0 0 0 0 0 0 0 0 0 10 0 0 0 16 16 16 16 16 
15 15 15 0 0 0 0 0 0 0 0 0 0 0 0 0 0 16 16 16 16 16 
15 15 15 0 0 0 0 0 0 10 0 0 0 0 0 0 0 16 16 16 16 16 
15 15 15 10 0 0 0 0 0 0 0 0 0 0 0 0 0 16 16 16 16 16 
15 15 15 0 0 0 0 0 0 0 0 0 0 0 0 0 0 16 16 16 16 16 
15 15 15 0 0 0 0 0 0 0 0 0 0 0 0 0 0 16 16 16 16 16 
15 15 15 10 10 0 0 10 10 0 0 10 0 0 0 0 0 16 16 16 16 16 
15 15 15 0 0 0 0 0 0 0 0 0 0 0 0 10 10 16 16 16 16 16 
15 15 15 0 0 0 0 0 0 0 0 0 0 0 0 0 0 16 16 16 16 16 
15 15 15 0 0 0 0 0 0 0 0 0 0 0 0 0 0 16 16 16 16 16 
15 15 15 0 0 0 0 0 0 0 0 0 0 0 0 0 0 16 16 16 16 16 
15 15 15 10 0 0 0 0 0 0 0 10 10 0 0 0 0 16 16 16 16 16 
15 15 15 0 0 0 0 0 0 0 0 0 0 0 0 0 0 16 16 16 16 16 
15 15 15 0 0 0 0 0 0 0 0 0 0 0 0 0 0 16 16 16 16 16 
15 15 15 0 0 0 10 10 10 10 0 0 0 0 0 0 0 16 16 16 16 16 
15 15 15 0 0 0 0 0 0 0 0 0 0 0 0 0 0 16 16 16 16 16 
15 15 15 0 0 0 0 0 0 0 0 0 0 0 0 0 0 16 16 16 16 16 
15 15 15 0 0 0 0 0 0 0 0 0 0 0 0 0 0 16 16 16 16 16 
15 15 15 10 10 10 10 10 10 10 10 0 0 0 0 10 10 16 16 16 16 16 
15 15 15 0 0 0 0 0 0 0 0 0 0 0 0 0 0 16 16 16 16 16 
15 15 15 0 0 0 0 0 0 0 0 0 0 0 0 0 0 16 16 16 16 16 
15 15 15 0 0 0 0 0 0 0 0 0 0 0 0 0 0 16 16 16 16 16 
15 15 15 0 0 0 0 10 10 10 10 10 10 0 0 0 0 16 16 16 16 16 
15 15 15 0 0 0 0 0 0 0 0 0 0 0 0 0 0 16 16 16 16 16 
15 15 15 0 0 0 0 0 0 0 0 0 0 0 0 0 0 16 16 16 16 16 
15 15 15 0 0 0 0 0 0 0 0 0 0 0 0 0 0 16 16 16 16 16 
15 15 15 10 10 10 10 10 0 0 0 0 10 10 10 10 10 16 16 16 16 16 
15 15 15 0 0 0 0 0 0 0 0 0 0 0 0 0 0 16 16 16 16 16 
15 15 15 0 0 0 0 0 0 0 0 0 0 0 0 0 0 16 16 16 16 16 
15 15 15 0 0 0 0 0 0 0 0 0 0 0 0 0 0 16 16 16 16 16 
15 15 15 0 0 10 10 0 0 10 10 0 0 10 10 0 0 16 16 16 16 16 
15 15 15 0 0 0 0 0 0 0 0 0 0 0 0 0 0 16 16 16 16 16 
15 15 15 0 0 0 0 0 0 0 0 0 0 0 0 0 0 16 16 16 16 16 
15 15 15 0 0 0 0 0 0 0 0 0 0 0 0 0 0 16 16 16 16 16 
15 15 15 10 10 0 0 10 10 0 0 10 10 0 0 10 10 16 16 16 16 16 
15 15 15 0 0 0 0 0 0 0 0 0 0 0 0 0 0 16 16 16 16 16 
15 15 15 0 0 0 0 0 0 0 0 0 0 0 0 0 0 16 16 16 16 16 
15 15 15 0 0 0 0 0 0 0 0 0 0 0 0 0 0 16 16 16 16 16 
15 15 15 10 10 10 10 10 0 0 0 0 10 10 10 10 10 16 16 16 16 16 
15 15 15 0 0 0 0 0 0 0 0 0 0 0 0 0 0 16 16 16 16 16 
15 15 15 0 0 0 0 0 0 0 0 0 0 0 0 0 0 16 16 16 16 16 
15 15 15 0 0 0 0 0 0 0 0 0 0 0 0 0 0 16 16 16 16 16 
15 15 15 0 0 10 10 10 10 10 10 10 10 10 10 0 0 16 16 16 16 16 
15 15 15 0 0 0 0 0 0 0 0 0 0 0 0 0 0 16 16 16 16 16 
15 15 15 0 0 0 0 0 0 0 0 0 0 0 0 0 0 16 16 16 16 16 
15 15 15 0 0 0 0 0 0 0 0 0 0 0 0 0 0 16 16 16 16 16 
15 15 17 17 17 17 17 17 17 17 17 17 17 17 17 17 17 17 16 16 16 16 
10 3 3 3 3 3 3 3 3 3 3 3 3 3 3 3 3 3 3 3 3 3 
10 3 3 3 3 3 3 3 3 3 3 3 3 3 3 3 3 3 3 3 3 3 
10 10 10 10 10 10 10 10 10 10 10 10 10 10 10 10 10 10 10 10 10 10 
