53
98
23 23 0 0 0 0 0 0 0 0 0 0 0 0 0 0 0 23 23 0 0 0 0 0 0 0 0 0 0 0 0 0 0 0 23 23 0 0 0 0 0 0 0 0 0 0 0 0 0 0 0 23 23 
23 23 0 0 0 0 0 0 0 0 0 0 0 0 0 0 0 23 23 0 0 0 0 0 0 0 0 0 0 0 0 0 0 0 23 23 0 0 0 0 0 0 0 0 0 0 0 0 0 0 0 23 23 
23 23 0 0 0 0 0 0 0 0 0 0 0 0 0 0 0 23 23 0 0 0 0 0 0 0 0 0 0 0 0 0 0 0 23 23 0 0 0 0 0 0 0 0 0 0 0 0 0 0 0 23 23 
23 23 0 0 0 0 0 0 0 0 0 0 0 0 0 0 0 23 23 0 0 0 0 0 0 0 0 0 0 0 0 0 0 0 23 23 0 0 0 0 0 0 0 0 0 0 0 0 0 0 0 23 23 
23 23 0 0 0 0 0 0 0 0 0 0 0 0 0 0 0 23 23 0 0 0 0 0 0 0 0 0 0 0 0 0 0 0 23 23 0 0 0 0 0 0 0 0 0 0 0 0 0 0 0 23 23 
23 23 0 0 0 0 0 0 0 0 0 0 0 0 0 0 0 23 23 0 0 0 0 0 0 0 0 0 0 0 0 0 0 0 23 23 0 0 0 0 0 0 0 0 0 0 0 0 0 0 0 23 23 
23 23 0 0 0 0 0 0 0 0 0 0 0 0 0 0 0 23 23 0 0 0 0 0 0 0 0 0 0 0 0 0 0 0 0 0 0 0 0 0 0 0 0 0 0 0 0 0 0 0 0 23 23 
23 23 0 0 0 0 0 0 0 0 0 0 0 0 0 0 0 23 23 0 0 0 0 0 0 0 0 0 0 0 0 0 0 0 0 0 0 0 0 0 0 0 0 0 0 0 0 0 0 0 0 23 23 
23 23 23 23 0 0 0 0 0 0 0 0 0 0 0 23 23 23 23 23 23 0 0 0 0 0 0 0 0 0 0 0 23 23 23 34 23 23 0 0 0 0 0 0 0 0 0 0 0 0 0 23 23 
23 23 0 0 0 0 0 0 0 0 0 0 0 0 0 0 0 23 23 0 0 23 0 0 0 0 0 0 0 0 0 23 0 0 23 23 0 0 0 0 0 0 0 0 0 0 0 0 0 0 0 23 23 
23 23 0 0 0 0 0 0 0 0 0 0 0 0 0 0 0 23 23 0 0 0 0 0 0 0 0 0 0 0 0 0 0 0 23 23 0 0 0 0 0 0 0 0 0 0 0 0 0 0 0 23 23 
23 0 0 0 0 0 0 0 0 0 0 0 0 0 0 0 0 0 0 0 0 0 0 0 0 0 0 0 0 0 0 0 0 0 0 23 0 0 0 0 0 0 0 0 0 0 0 0 0 0 0 23 23 
23 23 0 0 25 25 25 25 25 25 25 25 25 25 25 0 0 23 23 0 0 0 28 28 28 28 28 28 28 28 28 0 0 0 23 23 29 29 29 29 29 29 29 29 29 29 29 29 29 0 0 23 23 
23 23 0 0 0 0 0 0 0 0 0 0 0 0 0 0 0 23 23 0 0 0 28 0 0 0 0 0 0 0 28 0 0 0 23 23 0 0 0 0 0 0 0 0 0 0 0 0 0 0 0 23 23 
23 23 0 0 0 0 0 0 0 0 0 0 0 0 0 0 0 23 23 27 0 0 0 0 0 0 0 0 0 0 0 0 0 27 23 23 0 0 0 0 0 0 0 0 0 0 0 0 0 0 0 23 23 
23 23 0 0 0 0 0 0 0 0 0 0 0 0 0 0 0 23 23 0 0 0 0 0 0 0 0 0 0 0 0 0 0 0 23 23 0 0 0 0 0 0 0 0 0 0 0 0 0 0 0 23 23 
23 23 0 0 0 0 0 0 0 0 0 0 0 0 0 0 0 23 23 0 0 0 0 0 0 0 0 0 0 0 0 0 0 0 23 23 0 0 0 0 0 0 0 0 0 0 0 0 0 0 0 23 23 
23 23 0 0 0 0 0 0 0 0 0 0 0 0 0 0 0 23 23 30 30 0 0 0 0 0 0 0 0 0 0 0 30 30 23 23 0 0 0 0 0 0 0 0 0 0 0 0 0 0 0 23 23 
23 23 27 0 0 0 0 0 0 0 0 0 0 0 0 0 0 23 23 0 0 0 0 0 0 0 0 0 0 0 0 0 0 0 23 23 0 0 0 0 0 0 0 0 0 0 0 0 0 0 0 23 23 
23 23 0 0 0 0 0 0 0 0 0 0 0 0 0 0 0 23 23 0 0 0 27 0 0 0 0 0 0 0 27 0 0 0 23 23 0 0 0 0 0 0 0 0 0 0 0 0 0 0 0 23 23 
23 23 0 0 0 0 0 26 26 26 26 0 0 0 0 0 0 23 23 0 0 0 0 0 0 0 0 0 0 0 0 0 0 0 23 23 0 0 0 0 0 0 0 0 0 0 0 0 0 0 0 23 23 
23 23 0 0 0 0 0 26 0 0 26 0 0 0 0 0 0 23 23 0 0 0 0 0 25 0 0 0 25 0 0 0 0 0 23 23 0 0 0 0 0 0 0 0 0 0 0 0 0 0 0 23 23 
23 23 0 0 29 0 0 26 0 0 26 0 0 29 0 0 0 23 23 0 0 0 0 0 0 0 0 0 0 0 0 0 0 0 23 23 0 0 0 0 0 0 0 0 0 0 0 0 0 0 0 23 23 
23 23 0 0 0 0 0 0 0 0 0 0 0 0 0 0 0 23 23 0 0 0 0 0 0 0 0 0 0 0 0 0 0 0 23 23 0 0 0 0 0 0 0 0 0 0 0 0 0 0 0 23 23 
23 23 0 0 0 0 0 0 0 0 0 0 0 0 0 0 0 23 23 0 0 0 0 0 0 0 0 0 0 0 0 0 0 0 23 23 0 0 0 0 0 0 0 0 0 0 0 0 0 0 0 23 23 
23 23 0 0 0 0 0 0 0 0 0 0 0 0 0 0 0 23 23 0 0 0 0 0 0 0 28 28 28 28 28 0 0 0 23 23 0 0 0 0 0 0 0 0 0 0 0 0 0 0 0 23 23 
23 23 0 0 0 0 0 0 0 0 0 0 0 0 0 0 0 23 23 0 0 0 0 0 0 0 26 26 26 26 26 0 0 0 23 23 0 0 26 26 26 26 26 26 26 26 26 26 26 26 26 23 23 
23 23 0 0 0 0 0 0 0 0 0 0 0 0 0 0 0 23 23 0 0 0 0 0 0 0 0 0 0 0 0 0 0 0 23 23 0 0 0 0 0 0 0 0 0 0 0 0 0 0 0 23 23 
23 23 0 0 0 0 0 0 0 0 0 0 0 0 0 0 26 23 23 0 0 0 0 0 0 0 0 0 0 0 0 0 0 0 23 23 0 0 0 0 0 0 0 0 0 0 0 0 0 0 0 23 23 
23 23 0 0 0 0 0 0 0 0 0 0 0 0 0 0 0 23 23 0 0 0 0 0 0 0 0 0 0 0 0 0 0 27 23 23 0 0 0 0 0 0 0 0 0 0 0 0 0 0 0 23 23 
23 23 0 0 0 0 29 29 29 0 29 29 29 0 0 0 0 23 23 0 0 0 0 0 0 0 0 0 0 0 0 0 0 0 23 23 0 0 0 0 0 0 0 0 0 0 0 0 0 0 0 23 23 
23 23 0 0 0 0 29 0 29 0 29 0 29 0 0 0 0 23 23 0 0 0 0 0 0 0 0 0 0 0 0 0 0 0 23 23 0 0 0 0 0 0 0 0 0 0 0 0 0 0 0 23 23 
23 23 0 0 0 29 29 0 29 29 29 0 29 29 29 29 29 23 23 0 0 0 0 0 0 0 0 0 0 0 0 0 25 25 23 23 0 0 0 0 0 0 0 0 0 0 0 0 0 0 0 23 23 
23 23 0 0 0 0 0 0 0 0 0 0 0 0 0 0 0 23 23 0 0 28 0 0 0 0 0 0 0 0 0 0 0 0 23 23 0 0 0 0 0 0 0 0 0 0 0 0 0 0 0 23 23 
23 23 0 0 0 0 0 0 0 0 0 0 0 0 0 0 0 23 23 0 0 0 0 0 0 31 0 0 0 28 0 0 0 0 23 23 0 0 0 0 0 0 0 0 0 0 0 0 0 0 0 23 23 
23 23 0 0 0 0 0 0 0 0 0 0 0 0 0 0 0 23 23 0 0 0 0 0 0 0 0 0 0 0 0 0 0 0 23 23 0 0 0 0 0 0 0 0 0 0 0 0 0 0 0 23 23 
23 23 0 0 0 0 0 0 9 10 11 0 0 0 0 0 0 23 23 0 0 0 0 0 0 0 0 0 0 0 0 0 0 0 23 23 0 0 0 0 0 0 0 0 0 0 0 0 0 0 0 23 23 
23 23 25 25 0 0 0 0 28 28 28 0 0 0 0 0 0 23 23 25 25 0 0 0 0 0 0 0 0 0 0 0 0 0 23 23 0 0 0 0 0 0 0 0 0 0 0 0 0 0 0 23 23 
23 23 0 25 0 0 0 0 0 0 0 0 0 0 0 0 0 23 23 0 0 0 0 0 0 0 0 0 0 0 0 0 0 0 23 23 0 0 0 0 0 0 0 0 0 0 0 0 0 0 0 23 23 
23 23 0 25 0 0 0 0 0 0 0 0 0 0 0 0 0 23 0 0 0 0 0 0 0 0 0 0 0 0 0 0 0 0 0 23 0 0 0 0 0 0 0 0 0 0 0 0 0 0 0 23 23 
23 23 0 25 0 0 0 0 0 0 0 0 0 0 0 0 0 23 23 0 0 0 29 29 29 29 29 29 29 29 29 0 0 0 23 23 0 0 0 0 0 0 0 0 0 0 0 0 0 0 0 23 23 
23 23 0 25 25 25 25 0 25 25 25 0 25 25 0 0 0 23 23 0 0 0 0 0 0 0 0 0 0 0 0 0 0 0 23 23 0 0 0 0 0 0 0 0 0 0 0 0 0 0 0 23 23 
23 23 0 0 0 0 25 0 25 0 25 0 25 0 0 0 0 23 23 0 0 0 0 0 0 0 0 0 0 0 0 0 0 25 23 23 0 0 0 0 0 0 0 0 0 0 0 0 0 0 0 23 23 
23 23 0 0 0 0 25 25 25 0 25 25 25 0 0 0 0 23 23 0 0 0 0 0 0 0 0 0 0 0 0 0 0 0 23 23 0 0 0 0 0 0 0 0 0 0 0 0 0 0 0 23 23 
23 23 0 0 0 0 0 0 0 0 0 0 0 0 0 0 0 23 23 0 0 0 0 0 0 0 0 0 0 0 0 0 0 0 23 23 0 0 0 0 0 0 0 0 0 0 0 0 0 0 0 23 23 
23 23 0 0 0 0 0 0 0 0 0 0 0 0 0 0 0 23 23 0 0 0 0 0 0 0 0 0 0 0 31 0 0 0 23 23 0 0 0 0 0 0 0 0 0 0 0 0 0 0 0 23 23 
23 23 0 0 0 0 0 0 0 0 0 0 0 0 0 0 0 23 23 0 0 0 0 0 0 0 0 0 0 0 0 0 0 0 23 23 0 0 0 0 0 0 0 0 0 0 0 0 0 0 0 23 23 
23 23 0 0 0 0 0 0 0 0 0 0 0 0 0 0 0 23 23 0 0 0 0 0 0 0 0 0 0 0 0 0 0 0 23 23 0 0 0 0 0 0 0 0 0 0 0 0 0 0 0 23 23 
23 23 0 0 0 0 0 0 0 0 0 0 0 0 0 0 0 23 23 0 0 0 0 0 0 0 0 0 28 0 0 0 0 0 23 23 0 0 0 0 0 0 0 0 0 0 0 0 0 0 0 23 23 
23 23 0 0 0 0 0 0 0 0 0 0 0 0 0 0 0 23 23 0 0 0 0 0 0 0 0 0 0 0 0 0 0 0 23 23 0 0 0 0 0 0 0 0 0 0 0 0 0 0 0 23 23 
23 23 0 0 0 0 0 0 0 0 0 0 0 0 0 0 0 23 23 0 0 0 0 0 0 25 0 0 0 0 0 0 0 0 23 23 0 0 0 0 0 0 0 0 0 0 0 0 0 0 0 23 23 
23 23 0 0 0 0 0 0 0 0 0 0 0 0 0 0 0 23 23 0 0 0 0 0 0 0 0 0 0 0 0 0 0 0 23 23 0 0 0 0 0 0 0 0 0 0 0 0 0 0 0 23 23 
23 23 0 0 0 0 0 0 0 0 0 0 0 0 0 0 27 23 23 0 0 0 30 0 0 0 0 0 0 0 0 0 0 0 23 23 0 0 0 0 0 0 0 0 0 0 0 0 0 0 0 23 23 
23 23 0 0 0 0 0 0 0 0 0 0 0 0 0 0 0 23 23 0 0 0 0 0 0 0 0 0 0 0 0 0 0 0 23 23 0 0 0 0 0 0 0 0 0 0 0 0 0 0 0 23 23 
23 23 0 0 0 0 0 0 0 0 0 0 28 0 0 0 0 23 23 0 0 0 0 0 0 0 0 0 0 0 0 0 0 0 23 23 0 0 0 0 0 0 0 0 0 0 0 0 0 0 0 23 23 
23 23 0 0 0 0 0 0 0 0 0 0 0 0 0 0 0 23 23 0 0 25 0 0 0 0 0 0 0 0 0 0 0 0 23 23 0 0 0 0 0 0 0 0 0 0 0 0 0 0 0 23 23 
23 23 0 0 0 0 0 27 0 0 0 0 0 0 0 0 0 23 23 0 0 0 0 0 0 0 0 0 0 0 0 0 0 0 23 23 0 0 0 0 0 0 0 0 0 0 0 0 0 0 0 23 23 
23 23 0 0 0 0 0 0 0 0 0 0 0 0 0 0 0 23 23 28 0 0 0 26 0 0 0 0 29 0 0 0 0 0 23 23 0 0 0 0 0 0 0 0 0 0 0 0 0 0 0 23 23 
23 23 0 28 0 0 0 0 0 0 0 0 0 0 0 0 0 23 23 0 0 0 0 0 0 0 0 0 0 0 0 0 0 31 23 23 29 29 29 29 29 29 29 29 29 29 29 29 29 0 0 23 23 
23 23 0 0 0 0 0 0 0 0 0 0 0 0 0 0 0 23 23 0 0 0 0 0 0 0 0 0 0 0 0 0 0 0 23 23 0 0 0 0 0 0 0 0 0 0 0 0 0 0 0 23 23 
23 23 0 0 0 0 0 0 0 0 0 0 0 0 0 0 0 23 23 0 0 0 0 0 0 0 0 0 0 0 0 0 27 0 23 23 0 0 0 0 0 0 0 0 0 0 0 0 0 0 0 23 23 
23 23 0 0 0 0 0 0 0 0 0 0 0 0 0 0 0 23 23 0 0 0 0 0 0 0 0 0 0 0 0 0 0 0 23 23 0 0 0 0 0 0 0 0 0 0 0 0 0 0 0 23 23 
23 23 0 0 0 26 0 0 0 0 0 0 0 0 0 0 0 23 23 0 0 0 0 0 0 0 0 0 0 0 0 31 0 0 23 23 0 0 0 0 0 0 0 0 0 0 0 0 0 0 0 23 23 
23 23 0 0 0 0 0 0 0 0 0 0 0 0 0 0 0 23 23 0 0 0 0 0 0 0 0 0 0 0 0 0 0 0 23 23 0 0 0 0 0 0 0 0 0 0 0 0 0 0 0 23 23 
23 23 22 0 0 0 0 0 0 0 0 0 0 0 0 0 0 23 23 0 0 0 0 0 0 0 0 0 0 0 27 0 0 0 23 23 0 0 0 0 0 0 0 0 0 0 0 0 0 0 0 23 23 
23 23 0 0 0 0 0 0 0 0 0 28 0 0 0 0 0 23 23 0 0 0 0 0 0 0 0 31 31 0 0 0 0 0 23 23 0 0 0 0 0 0 0 0 0 0 0 0 0 0 0 23 23 
23 23 0 0 0 0 0 0 0 0 0 0 0 0 0 0 0 23 23 0 0 0 0 0 27 27 0 0 0 0 0 0 0 0 23 23 0 0 31 0 30 30 30 0 29 29 29 29 0 28 28 23 23 
23 23 0 0 0 0 0 0 0 0 0 0 0 0 0 0 0 23 23 0 0 0 0 0 0 0 0 0 0 0 0 0 0 0 23 23 0 0 0 27 0 0 0 26 0 0 0 0 25 0 0 23 23 
23 23 0 0 0 0 0 0 0 0 0 0 0 0 0 0 0 23 23 0 0 30 30 0 0 0 0 0 0 0 0 0 0 0 23 23 0 0 0 0 0 0 0 0 0 0 0 0 0 0 0 23 23 
23 23 0 0 0 0 0 0 0 0 0 0 0 0 0 27 27 23 23 0 0 0 0 0 0 0 0 0 0 0 0 0 0 0 23 23 0 0 0 0 0 0 0 0 0 0 0 0 0 0 0 23 23 
23 23 0 0 0 0 0 0 0 0 0 0 0 30 30 0 0 23 23 0 0 0 0 0 0 0 0 0 0 0 0 0 0 0 23 23 0 0 0 0 0 0 0 0 0 0 0 0 0 0 0 23 23 
23 23 0 0 0 0 0 0 0 0 0 26 26 0 0 0 0 23 23 0 0 0 0 0 0 0 0 0 0 0 0 0 0 0 23 23 0 0 0 0 0 0 0 0 0 0 0 0 0 0 0 23 23 
23 23 0 0 0 0 0 0 0 0 30 0 0 0 0 0 0 23 23 27 0 0 0 0 0 0 0 0 0 0 0 0 0 0 23 23 0 0 0 0 0 0 0 0 0 0 0 0 0 0 0 23 23 
23 23 0 0 0 0 0 0 0 0 30 0 0 0 0 0 0 23 23 0 0 0 29 29 29 29 29 29 29 0 0 0 0 0 23 23 0 0 0 0 0 0 0 0 0 0 0 0 0 0 0 23 23 
23 23 0 0 0 0 0 0 26 26 0 0 0 0 0 0 0 23 23 0 0 0 0 0 0 0 0 0 0 0 0 0 0 0 23 23 0 0 0 0 0 0 0 0 0 0 0 0 0 0 0 23 23 
23 23 0 0 0 0 0 29 0 0 0 0 0 0 0 0 0 23 23 0 0 0 0 0 0 0 0 0 0 0 0 0 0 0 23 23 0 0 0 0 0 0 0 0 0 0 0 0 0 0 0 23 23 
23 23 0 0 0 0 0 29 0 0 0 0 0 0 0 0 0 23 23 0 0 0 0 0 0 0 0 0 0 0 0 0 0 0 23 23 0 0 0 0 0 0 0 0 0 0 0 0 0 0 0 23 23 
23 23 0 0 0 26 26 0 0 0 0 0 0 0 0 0 0 23 23 0 0 0 0 0 0 0 0 0 0 0 0 0 30 30 23 23 0 0 0 0 0 0 0 0 0 0 0 0 0 0 0 23 23 
23 23 0 0 0 0 0 0 0 0 0 0 0 0 0 0 0 23 23 0 0 0 0 0 0 0 0 0 0 0 0 0 0 0 23 23 0 0 0 0 0 0 0 0 0 0 0 0 0 0 0 23 23 
23 23 0 0 0 0 0 0 0 0 0 0 0 0 0 0 0 23 23 0 0 0 0 0 0 0 0 0 0 0 0 0 0 0 23 23 0 0 0 0 0 0 0 0 0 0 0 0 0 0 0 23 23 
23 23 27 0 0 0 0 0 0 0 0 0 0 0 0 0 0 23 23 0 0 0 25 25 25 25 25 25 25 25 25 25 0 0 23 23 25 25 25 25 0 0 0 0 27 0 0 0 0 27 0 23 23 
23 23 0 30 0 0 0 0 0 0 0 0 0 0 0 0 0 23 23 0 0 0 0 0 0 0 0 0 0 0 0 0 0 0 23 23 0 0 0 0 28 28 28 28 0 31 31 31 31 0 0 23 23 
23 23 0 0 27 27 0 0 0 0 0 0 0 0 0 0 0 23 23 0 0 0 0 0 0 0 0 0 0 0 0 0 0 0 23 23 0 0 0 0 0 0 0 0 0 0 0 0 0 0 0 23 23 
23 23 0 0 0 0 0 0 0 0 0 0 0 0 0 0 0 23 23 28 28 0 0 0 0 0 0 0 0 0 0 0 0 0 23 23 0 0 0 0 0 0 0 0 0 0 0 0 0 0 0 23 23 
23 23 0 0 0 0 0 0 0 0 0 0 0 0 0 0 0 23 23 0 0 0 0 0 0 0 0 0 0 0 0 0 0 0 23 23 0 0 0 0 0 0 0 0 0 0 0 0 0 0 0 23 23 
23 23 0 0 0 0 0 0 0 0 0 0 0 0 0 0 0 23 23 0 0 0 0 0 0 0 0 0 0 0 0 0 0 0 23 23 0 0 0 0 0 0 0 0 0 0 0 0 0 0 0 23 23 
23 23 0 0 0 0 0 0 0 0 0 0 0 0 0 0 0 23 23 0 0 0 0 0 0 0 0 0 0 0 0 0 0 0 23 23 0 0 0 0 0 0 0 0 0 0 0 0 0 0 0 23 23 
23 23 0 0 0 0 0 0 0 0 0 0 0 0 0 0 0 23 23 0 27 27 27 27 27 27 27 27 27 27 27 0 0 0 23 23 0 0 0 0 0 0 0 0 0 0 0 0 0 0 0 23 23 
23 23 0 0 0 0 0 0 0 0 0 0 0 0 0 0 0 23 23 0 0 0 0 0 0 0 0 0 0 0 0 0 0 0 23 23 0 0 0 0 0 0 0 0 0 0 0 0 0 0 0 23 23 
23 23 0 0 0 0 0 0 0 0 0 0 0 0 0 0 0 23 23 0 0 0 0 0 0 0 0 0 0 0 0 0 0 0 23 23 0 0 0 0 0 0 0 0 0 0 0 0 0 0 0 23 23 
23 23 0 0 0 0 0 0 0 0 0 0 0 0 0 0 0 23 23 0 0 0 0 0 0 0 0 0 0 0 0 0 0 23 23 23 0 0 0 0 0 0 0 0 0 0 0 0 0 0 0 23 23 
23 23 0 0 0 0 0 0 0 0 0 0 0 0 0 0 0 0 0 0 0 0 0 0 0 0 0 0 0 0 0 0 0 0 23 23 0 17 0 0 0 0 0 0 0 0 40 0 0 0 0 23 23 
23 23 0 0 0 0 0 0 0 0 0 0 0 0 0 0 0 0 0 0 0 0 0 0 0 0 0 0 0 0 0 0 0 0 23 23 0 0 0 0 0 42 0 0 0 0 41 0 0 0 0 23 23 
23 23 23 23 23 23 23 23 23 23 23 23 23 23 23 23 23 23 23 23 23 0 0 0 33 31 0 0 0 23 23 23 0 0 23 23 23 23 23 23 23 23 23 23 23 23 23 23 23 23 23 23 23 
0 0 0 0 0 0 0 0 0 0 0 0 0 0 0 0 0 0 0 0 0 0 0 0 0 0 0 0 0 0 0 0 0 0 0 0 0 0 0 0 0 0 0 0 0 0 0 0 0 0 0 0 0 
0 0 0 0 0 0 0 0 0 0 0 0 0 0 0 0 0 0 0 0 0 0 0 0 0 0 0 0 0 0 0 0 0 0 0 0 0 0 0 0 0 0 0 0 0 0 0 0 0 0 0 0 0 
0 0 0 0 0 0 0 0 0 0 0 0 0 0 0 0 0 0 0 0 0 0 0 0 0 0 0 0 0 0 0 0 0 0 0 0 0 0 0 0 0 0 0 0 0 0 0 0 0 0 0 0 0
0 0 0 0 0 0 0 0 0 0 0 0 0 0 0 0 0 0 0 0 0 0 0 0 0 0 0 0 0 0 0 0 0 0 0 0 0 0 0 0 0 0 0 0 0 0 0 0 0 0 0 0 0 