15
8
17 17  0  0  0  0  0  0  0  0  0  0  0  0  11  
17 17  0  0  0  0  0  0  0  0  0  0  0  0  11
17 17  0  0  0  0  0  0  0  0  0  0  0  0  11
17 17  0  0  0  0  0  0  0  0  0  0  0  0  11
17 17  0  0  0  0  0  0  0  0  0  0  0  0  11
17 17  0  0  0  0  0  0  0  0  0  0  0  0  11
17 17  0  0  0  0  0  0  0  0  0  0  0  11 11 
10 10  10 10 10 10 10 10 10 10 10 10 10 10 10 