100
27
10 10 10 10 10 10 10 10 10 10 10 10 10 10 10 10 10 10 10 10 10 10 10 10 10 10 10 10 10 10 10 10 10 10 10 10 10 10 10 10 10 10 10 10 10 10 10 10 10 10 10 10 10 10 10 10 10 10 10 10 10 10 10 10 10 10 10 10 10 10 10 10 10 10 10 10 10 10 10 10 10 10 10 10 10 10 10 10 10 10 10 10 10 10 10 10 10 10 10 10
11 2  4  4  4  4  4  4  4  4  4  4  4  4  4  4  4  4  4  4  4  4  4  4  4  4  4  4  4  4  4  4  4  4  4  4  4  4  4  4  4  4  4  4  4  4  4  4  4  4  4  4  4  4  4  4  4  4  4  4  4  4  4  4  4  4  4  4  4  4  4  4  4  4  4  4  4  4  4  4  4  4  4  4  4  4  4  4  4  4  4  4  4  4  4  4  4  4  5  11  
10 3  3  3  3  3  3  3  3  3  3  3  3  3  3  3  3  3  3  3  3  3  3  3  3  3  3  3  3  3  3  3  3  3  3  3  3  3  3  3  3  3  3  3  3  3  3  3  3  3  3  3  3  3  3  3  3  3  3  3  3  3  3  3  3  3  3  3  3  3  3  3  3  3  3  3  3  3  3  3  3  3  3  3  3  3  3  3  3  3  3  3  3  3  3  3  3  3  5  10
10 3  3  3  3  3  3  3  3  3  3  3  3  3  3  3  3  3  3  3  3  3  3  3  3  3  3  3  3  3  3  3  3  3  3  3  3  3  3  3  3  3  3  3  3  3  3  3  3  3  3  3  3  3  3  3  3  3  3  3  3  3  3  3  3  3  3  3  3  3  3  3  3  3  3  3  3  3  3  3  3  3  3  3  3  3  3  3  3  3  3  3  3  3  3  3  3  3  5  10
10 3  3  3  3  3  3  3  3  3  3  3  3  3  3  3  3  3  3  3  3  3  3  3  3  3  3  3  3  3  3  3  3  3  3  3  3  3  3  3  3  3  3  3  3  3  3  3  3  3  3  3  3  3  3  3  3  3  3  3  3  3  3  3  3  3  3  3  3  3  3  3  3  3  3  3  3  3  3  3  3  3  3  3  3  3  3  3  3  3  3  3  3  3  3  3  3  3  5  10
10 3  3  3  3  3  3  3  3  3  3  3  3  3  3  3  3  3  3  3  3  3  3  3  3  3  3  3  3  3  3  3  3  3  3  3  3  3  3  3  3  3  3  3  3  3  3  3  3  3  3  3  3  3  3  3  3  3  3  3  3  3  3  3  3  3  3  3  3  3  3  3  3  3  3  3  3  3  3  3  3  3  3  3  3  3  3  3  3  3  3  3  3  3  3  3  3  3  5  10
10 3  3  3  3  3  3  3  3  3  3  3  3  3  3  3  3  3  3  3  3  3  3  3  3  3  3  3  3  3  3  3  3  3  3  3  3  3  3  3  3  3  3  3  3  3  3  3  3  3  3  3  3  3  3  3  3  3  3  3  3  3  3  3  3  3  3  3  3  3  3  3  3  3  3  3  3  3  3  3  3  3  3  3  3  3  3  3  3  3  3  3  3  3  3  3  3  3  5  10
10 3  3  3  3  3  3  3  3  3  3  3  3  3  3  3  3  3  3  3  3  3  3  3  3  3  3  3  3  3  3  3  3  3  3  3  3  3  3  3  3  3  3  3  3  3  3  3  3  3  3  3  3  3  3  3  3  3  3  3  3  3  3  3  3  3  3  3  3  3  3  3  3  3  3  3  3  3  3  3  3  3  3  3  3  3  3  3  3  3  3  3  3  3  3  3  3  3  5  10
10 3  3  3  3  3  3  3  3  3  3  3  3  3  3  3  3  3  3  3  3  3  3  3  3  3  3  3  3  3  3  3  3  3  3  3  3  3  3  3  3  3  3  3  3  3  3  3  3  10 3  3  3  3  10 3  3  3  3  10 3  3  3  3  10 10 10 10 10 10 3  3  3  3  3  3  3  3  3  3  3  3  3  10 10 10 3  3  3  3  3  3  3  3  3  3  3  3  5  10
10 3  3  3  3  3  3  3  3  3  3  3  3  3  3  3  3  3  3  3  3  3  3  3  3  3  3  3  3  3  3  3  3  3  3  3  3  3  3  3  3  3  3  3  10 10 3  3  3  10 10 10 10 10 10 3  3  3  3  10 10 10 10 10 10 10 10 10 10 10 3  3  3  3  3  3  3  3  10 3  3  3  3  3  3  10 3  3  3  3  3  3  3  3  3  3  3  3  5  10
10 3  3  3  3  3  3  3  3  3  3  3  3  3  3  3  3  3  3  3  3  3  3  3  3  3  3  3  3  3  3  3  10 3  3  3  3  3  3  3  10 10 3  3  10 10 3  3  3  10 10 10 10 10 10 3  3  3  3  10 10 10 10 10 10 10 10 10 10 10 3  3  3  10 3  3  3  3  3  3  3  3  3  3  3  10 3  3  3  3  3  3  3  3  3  3  3  3  5  10
10 3  3  3  3  3  3  3  3  3  3  3  3  3  3  3  3  3  3  3  3  3  3  3  3  3  3  3  3  3  3  10 10 3  3  3  3  10 3  3  10 10 3  3  10 10 3  3  3  10 10 10 10 10 10 10 10 10 10 10 10 10 10 10 10 10 10 10 10 10 3  3  3  3  3  3  3  3  3  3  3  3  3  3  3  10 3  3  3  3  3  3  3  3  3  3  3  3  5  10
10 3  3  3  3  3  3  3  3  3  3  3  3  3  3  3  3  3  3  3  3  3  3  3  3  3  3  3  3  3  10 10 10 3  3  3  3  10 3  3  10 10 3  3  10 10 3  3  3  10 10 10 10 10 10 10 10 10 10 10 10 10 10 10 10 10 10 10 10 10 3  3  3  3  3  3  3  3  3  3  3  3  3  3  3  10 3  3  3  3  3  3  3  3  3  3  3  3  5  10
10 3  3  3  3  3  3  3  3  3  3  3  3  3  3  3  3  3  3  3  3  3  3  3  3  3  3  3  3  10 10 10 10 3  3  3  3  10 3  3  10 10 3  3  10 10 3  3  3  10 10 10 10 10 10 10 10 10 10 10 10 10 10 10 10 10 10 10 10 10 3  3  3  3  3  3  3  3  3  3  3  3  3  3  3  10 3  3  3  3  3  3  3  3  3  3  3  3  5  10
10 3  3  3  3  3  3  3  3  3  3  3  3  3  3  3  3  3  3  3  3  3  3  3  3  3  3  3  10 10 10 10 10 3  3  3  3  10 3  3  10 10 3  3  10 10 3  3  3  10 10 10 10 10 10 10 10 10 10 10 10 10 10 10 10 10 10 10 10 10 3  3  3  3  3  3  3  3  3  3  3  3  3  3  3  10 3  3  3  3  3  3  3  3  3  3  3  3  5  10
10 3  3  3  3  3  3  3  3  3  3  3  3  3  3  3  3  3  3  3  3  3  3  3  3  3  3  10 10 10 10 10 10 3  3  3  3  10 3  3  10 10 3  3  10 10 3  3  3  10 10 10 10 10 10 10 10 10 10 10 10 10 10 10 10 10 10 10 10 10 3  3  3  3  3  3  3  3  3  3  3  3  3  3  3  10 3  3  3  3  3  3  3  3  3  3  3  3  5  10
10 3  3  3  3  3  3  3  3  3  3  3  3  3  3  3  3  3  3  3  3  3  3  3  3  3  10 10 10 10 10 10 10 3  3  3  3  10 3  3  10 10 3  3  10 10 3  3  3  10 10 10 10 10 10 10 10 10 10 10 10 10 10 10 10 10 10 10 10 10 3  3  3  3  3  3  3  3  3  3  3  3  3  3  3  10 3  3  3  3  3  3  3  3  3  3  3  3  5  10
10 3  3  3  3  3  3  3  3  3  3  3  3  3  3  3  3  3  3  3  3  3  3  3  3  10 10 10 10 10 10 10 10 3  3  3  3  10 3  3  10 10 3  3  10 10 3  3  3  10 10 10 10 10 10 10 10 10 10 10 10 10 10 10 10 10 10 10 10 10 3  3  3  3  3  3  3  3  3  3  3  3  3  3  3  10 3  3  3  3  3  3  3  3  3  3  3  3  5  10
10 3  3  3  3  3  3  3  3  3  3  3  3  3  3  3  3  3  3  3  3  3  3  3  10 10 10 10 10 10 10 10 10 3  3  3  3  10 3  3  10 10 3  3  10 10 3  3  3  10 10 10 10 10 10 10 10 10 10 10 10 10 10 10 10 10 10 10 10 10 3  3  3  3  3  3  3  3  3  3  3  3  3  3  3  10 3  3  3  3  3  3  3  3  3  3  3  3  5  10
10 3  3  3  3  3  3  3  3  3  3  3  3  3  3  3  3  3  3  3  10 3  3  3  10 10 10 10 10 10 10 10 10 3  3  3  3  10 3  3  10 10 3  3  10 10 3  3  3  10 10 10 10 10 10 10 10 10 10 10 10 10 10 10 10 10 10 10 10 10 3  3  3  3  3  3  3  3  3  3  3  3  3  3  3  10 3  3  3  3  3  3  3  3  3  3  3  3  5  10
10 3  3  3  3  3  3  3  3  3  3  10 3  3  3  3  10 3  3  3  10 3  3  3  10 10 10 10 10 10 10 10 10 3  3  3  3  10 3  3  10 10 3  3  10 10 3  3  3  10 10 10 10 10 10 10 10 10 10 10 10 10 10 10 10 10 10 10 10 10 3  3  3  3  3  3  3  3  3  3  3  3  3  3  3  10 3  3  3  3  3  3  3  3  3  3  3  3  5  10
10 3  3  3  3  3  3  3  10 3  3  10 10 10 10 10 10 3  3  3  10 3  3  3  10 10 10 10 10 10 10 10 10 3  3  3  3  10 3  3  10 10 3  3  10 10 3  3  3  10 10 10 10 10 10 10 10 10 10 10 10 10 10 10 10 10 10 10 10 10 3  3  3  3  3  3  3  3  3  3  3  3  3  3  3  10 3  3  3  3  3  3  3  3  3  3  3  3  5  10
10 10 10 10 10 3  3  3  10 3  3  10 10 10 10 10 10 3  3  3  10 3  3  3  10 10 10 10 10 10 10 10 10 3  3  3  3  10 3  3  10 10 3  3  10 10 3  3  3  10 10 10 10 10 10 10 10 10 10 10 10 10 10 10 10 10 10 10 10 10 3  3  3  3  3  3  3  3  3  3  3  3  3  3  3  10 3  3  3  3  3  3  3  3  3  3  3  3  5  10
10 10 10 10 10 3  3  3  10 3  3  10 10 10 10 10 10 3  3  3  10 3  3  3  10 10 10 10 10 10 10 10 10 3  3  3  3  10 3  3  10 10 3  3  10 10 3  3  3  10 10 10 10 10 10 10 10 10 10 10 10 10 10 10 10 10 10 10 10 10 3  3  3  3  3  3  3  3  3  3  3  3  3  3  3  10 10 10 10 10 10 10 10 10 10 10 10 10 10 10
10 3  3  3  3  3  3  3  3  3  3  3  3  3  3  3  3  3  3  3  3  3  3  3  3  3  3  3  3  3  3  3  3  3  3  3  10 3  3  3  3  3  3  3  3  3  3  3  10 3  3  3  3  3  3  3  3  3  3  3  3  3  3  3  3  3  3  3  3  3  3  3  3  3  3  3  3  3  3  3  3  3  3  3  3  3  3  3  3  10 10 3  3  10 10 10 10 10 5  10
10 3  3  3  3  3  3  3  3  3  3  3  3  3  3  3  3  3  3  3  3  3  3  3  3  3  3  3  3  3  3  3  3  3  3  3  10 3  3  3  3  3  3  3  3  3  3  3  10 3  3  3  3  3  3  3  3  3  3  3  3  3  3  3  3  3  3  3  3  3  3  3  3  3  3  3  3  3  3  3  3  3  3  3  3  3  3  3  3  10 10 3  3  10 10 10 10 10 5  10
10 10 10 10 10 10 10 10 10 10 10 10 10 10 10 10 10 10 10 10 10 10 10 10 10 10 10 10 10 10 10 10 10 10 10 10 10 10 10 10 10 10 10 10 10 10 10 10 10 10 10 10 10 10 10 10 10 10 10 10 10 10 10 10 10 10 10 10 10 10 10 10 10 10 10 10 10 10 10 10 10 10 10 10 10 10 10 10 10 10 10 10 10 10 10 10 10 10 5  10