25
103
22 23 23 23 23 23 23 23 23 23 23 23 23 23 21 21 21 21 21 21 21 21 21 21 21 
22 12 12 12 12 12 12 12 12 12 12 12 12 12 12 12 12 12 12 12 12 12 12 12 21 
22 12 12 12 12 12 12 12 12 12 12 12 12 12 12 12 12 12 12 12 12 12 12 12 21 
22 12 12 12 12 12 12 12 12 12 12 12 12 12 12 12 12 12 12 12 12 12 12 12 21 
22 12 12 12 12 12 23 23 23 23 23 23 23 23 23 23 23 23 23 23 23 23 12 12 21 
22 12 12 12 12 12 12 12 12 12 12 23 23 23 23 23 23 23 23 23 23 23 12 12 21 
22 12 12 12 12 12 12 12 12 12 12 23 23 23 23 23 23 23 23 23 23 23 12 12 21 
22 12 12 12 12 12 12 12 12 12 12 23 23 23 23 23 23 23 23 23 23 23 12 12 21 
22 23 12 12 12 24 24 12 12 12 12 23 23 23 23 23 23 23 23 23 23 23 12 12 21 
22 12 12 12 12 12 12 12 12 12 12 23 23 23 23 23 23 23 23 23 23 23 12 12 21 
22 12 12 12 12 12 12 12 12 12 24 23 23 23 23 23 23 23 23 23 23 23 12 12 21 
22 12 12 12 12 12 12 12 12 12 12 23 23 23 23 23 23 23 23 23 23 23 12 12 21 
22 12 12 12 12 12 12 12 12 12 12 23 23 23 23 23 23 23 23 23 23 23 12 12 21 
22 12 12 12 12 12 12 12 12 12 12 23 23 23 23 23 23 23 23 23 23 23 12 12 21 
22 12 12 12 12 12 12 12 24 12 12 23 23 23 23 23 23 23 23 23 23 23 12 12 21 
22 12 12 12 12 12 12 12 12 12 12 23 23 23 23 23 23 23 23 23 23 23 12 12 21 
22 12 12 12 12 12 12 12 12 12 12 23 23 23 23 23 23 23 23 23 23 23 12 12 21 
22 12 12 12 12 12 12 12 12 12 12 23 23 23 23 23 23 23 23 23 23 23 12 12 21 
22 12 12 12 12 12 24 12 12 12 12 23 23 23 23 23 23 23 23 23 23 23 12 12 21 
22 12 12 12 12 12 12 12 12 12 12 23 23 23 23 23 23 23 23 23 23 23 12 12 21 
22 12 12 12 12 12 12 12 12 12 12 23 23 23 23 23 23 23 23 23 23 23 12 12 21 
22 12 12 12 12 12 12 12 12 12 12 23 23 23 23 23 23 23 23 23 23 23 12 12 21 
22 12 12 12 24 12 12 12 12 12 12 23 23 23 23 23 23 23 23 23 23 23 12 12 21 
22 12 12 12 12 12 12 12 12 12 12 23 23 23 23 23 23 23 23 23 23 23 12 12 21 
22 12 12 12 12 12 12 12 12 12 12 23 23 23 23 23 23 23 23 23 23 23 12 12 21 
22 12 12 12 12 12 12 12 12 12 12 23 23 23 23 23 23 23 23 23 23 23 12 12 21 
22 24 24 12 12 12 12 12 12 12 12 23 23 23 23 23 23 23 23 23 23 23 12 12 21 
22 12 12 12 12 12 12 12 12 12 12 23 23 23 23 23 23 23 23 23 23 23 12 12 21 
22 12 12 12 12 12 12 12 12 12 12 23 23 23 23 23 23 23 23 23 23 23 12 12 21 
22 12 12 12 12 12 12 12 12 12 12 23 23 23 23 23 23 23 23 23 23 23 12 12 21 
22 12 12 12 12 12 27 28 12 12 12 23 23 23 23 23 23 23 23 23 23 23 12 12 21 
22 12 12 12 12 12 12 12 12 12 12 23 23 23 23 23 23 23 23 23 23 23 12 12 21 
22 12 12 12 12 12 12 12 12 12 12 23 23 23 23 23 23 23 23 23 23 23 12 12 21 
22 12 12 12 12 12 12 12 12 12 12 23 23 23 23 23 23 23 23 23 23 23 12 12 22 
22 12 12 12 12 12 12 12 12 27 24 23 23 23 23 23 23 23 23 23 23 23 12 12 22 
22 12 12 12 12 12 12 12 12 12 12 23 23 23 23 23 23 23 23 23 23 23 12 12 22 
22 12 12 12 12 12 12 12 12 12 12 23 23 23 23 23 23 23 23 23 23 23 12 12 22 
22 24 24 24 24 12 12 12 12 12 12 23 23 23 23 23 23 23 23 23 23 23 12 12 22 
22 12 12 12 12 12 12 12 12 12 12 23 23 23 23 23 23 23 23 23 23 23 12 12 22 
22 12 12 12 12 12 12 12 12 12 12 23 23 23 23 23 23 23 23 23 23 23 12 12 22 
22 12 12 12 12 12 12 12 12 12 12 23 23 23 23 23 23 23 23 23 23 23 12 12 22 
22 12 12 12 12 12 12 24 24 24 24 23 23 23 23 23 23 23 23 23 23 23 12 12 22 
22 12 12 12 12 12 12 12 12 12 12 23 23 23 23 23 23 23 23 23 23 23 12 12 22 
22 12 12 12 12 12 12 12 12 12 12 23 23 23 23 23 23 23 23 23 23 23 12 12 22 
22 12 12 12 12 12 12 12 12 12 12 23 23 23 23 23 23 23 23 23 23 23 12 12 22 
22 24 24 24 24 12 12 12 12 12 12 23 23 23 23 23 23 23 23 23 23 23 12 12 22 
22 12 12 12 12 12 12 12 12 12 12 23 23 23 23 23 23 23 23 23 23 23 12 12 22 
22 12 12 12 12 12 12 12 12 12 12 23 23 23 23 23 23 23 23 23 23 23 12 12 22 
22 12 12 12 12 12 12 12 12 12 12 23 23 23 23 23 23 23 23 23 23 23 12 12 22 
22 12 12 12 12 12 12 24 24 24 24 23 23 23 23 23 23 23 23 23 23 23 12 12 22 
22 12 12 12 12 12 12 12 12 12 12 23 23 23 23 23 23 23 23 23 23 23 12 12 22 
22 12 12 12 12 12 12 12 12 12 12 23 23 23 23 23 23 23 23 23 23 23 12 12 22 
22 12 12 12 24 24 12 12 12 12 12 23 23 23 23 23 23 23 23 23 23 23 12 12 22 
22 12 12 12 12 12 12 12 12 12 12 23 23 23 23 23 23 23 23 23 23 23 12 12 22 
22 12 12 12 12 12 12 12 12 12 12 23 23 23 23 23 23 23 23 23 23 23 12 12 22 
22 12 12 12 12 12 12 12 12 12 12 23 23 23 23 23 23 23 23 23 23 23 12 12 22 
22 12 24 24 12 12 24 24 12 12 12 23 23 23 23 23 23 23 23 23 23 23 12 12 22 
22 12 12 12 12 12 12 12 12 12 12 23 23 23 23 23 23 23 23 23 23 23 12 12 22 
22 12 12 12 12 12 12 12 12 12 12 23 23 22 23 23 23 23 23 23 23 23 12 12 22 
22 12 12 12 12 12 12 12 12 12 24 23 23 22 22 22 22 22 22 22 22 23 12 12 22 
22 12 12 12 12 12 12 12 12 12 12 23 23 22 22 22 22 22 22 22 22 23 12 12 22 
22 12 12 12 12 12 12 12 12 12 12 23 23 22 22 22 22 22 22 22 22 23 12 12 22 
22 12 12 12 12 12 12 12 12 12 12 23 23 22 22 22 22 22 22 22 22 23 12 12 22 
22 24 24 12 12 12 12 12 12 24 24 23 23 22 22 22 22 22 22 22 22 23 12 12 22 
22 12 12 12 12 12 12 12 12 12 12 23 23 22 22 22 22 22 22 22 22 23 12 12 22 
22 12 12 12 12 12 12 12 12 12 12 23 23 22 22 22 22 22 22 22 22 23 12 12 22 
22 12 12 12 12 12 12 12 12 12 12 23 23 22 22 22 22 22 22 22 22 23 12 12 22 
22 12 12 12 24 24 12 12 12 12 12 23 23 22 22 22 22 22 22 22 22 23 12 12 22 
22 12 12 12 12 12 12 12 12 12 12 23 23 22 22 22 22 22 22 22 22 23 12 12 22 
22 12 12 12 12 12 12 12 12 12 12 23 23 22 22 22 22 22 22 22 22 23 12 12 22 
22 12 12 12 12 12 12 12 12 12 12 23 23 22 22 22 22 22 22 22 22 23 12 12 22 
22 12 12 12 12 12 12 24 12 12 12 23 23 22 22 22 22 22 22 22 22 23 12 12 22 
22 12 12 12 12 12 12 12 12 12 12 23 23 22 22 22 22 22 22 22 22 23 12 12 22 
22 12 12 12 12 12 12 12 12 12 12 23 23 22 22 22 22 22 22 22 22 23 12 12 22 
22 12 12 12 12 12 12 12 12 12 12 23 23 22 22 22 22 22 22 22 22 23 12 12 22 
22 12 12 12 12 12 12 12 12 12 24 23 23 22 22 22 22 22 22 22 22 23 12 12 22 
22 12 12 12 12 12 12 12 12 12 12 23 23 22 22 22 22 22 22 22 22 23 12 12 22 
22 12 12 12 12 12 12 12 12 12 12 23 23 22 22 22 22 22 22 22 22 23 12 12 22 
22 12 12 12 24 24 24 24 12 12 12 23 23 22 22 22 22 22 22 22 22 23 12 12 22 
22 12 12 12 12 12 12 12 12 12 12 23 23 22 22 22 22 22 22 22 22 23 12 12 22 
22 12 12 12 12 12 12 12 12 12 12 23 23 22 22 22 22 22 22 22 22 23 12 12 23 
23 12 12 12 12 12 12 12 12 12 12 23 23 22 22 22 22 22 22 22 22 23 12 12 23 
23 24 24 24 24 24 12 12 12 12 12 23 23 22 22 22 22 22 22 22 22 23 12 12 22 
23 12 12 12 12 12 12 12 12 12 12 23 23 22 22 22 22 22 22 22 22 23 12 12 22 
23 12 12 12 12 12 12 12 12 12 12 23 23 22 22 22 22 22 22 22 22 23 12 12 22 
23 12 12 12 12 12 12 12 12 12 12 23 23 22 22 22 22 22 22 22 22 23 12 12 22 
23 12 12 12 12 12 12 12 12 12 24 23 23 22 22 22 22 22 22 22 22 23 12 12 22 
23 12 12 12 12 12 12 12 12 12 12 23 23 22 22 22 22 22 22 22 22 22 12 12 22 
23 12 12 12 12 12 12 12 12 12 12 23 23 22 22 22 22 22 22 22 22 22 12 12 22 
23 12 12 12 12 12 12 12 12 27 24 23 23 22 22 22 22 22 22 22 22 22 12 12 22 
23 12 12 12 12 12 12 12 12 12 12 23 23 22 22 22 22 22 22 22 22 23 12 12 22 
23 12 12 12 12 12 12 12 12 12 12 23 23 22 22 22 22 22 22 22 22 23 12 12 22 
22 12 12 12 27 28 12 12 12 12 12 23 23 22 22 22 22 22 22 22 22 23 12 12 22 
22 12 12 12 12 12 12 12 12 12 12 23 23 22 22 22 22 22 22 22 22 22 12 12 22 
22 12 12 12 12 12 12 12 12 12 12 23 23 22 22 22 22 22 22 22 22 22 12 12 22 
22 24 28 12 12 12 12 12 12 12 12 23 23 22 22 22 22 22 22 22 22 22 12 12 22 
22 12 12 12 12 12 12 12 12 12 12 23 23 22 22 22 22 22 22 22 22 23 12 12 22 
22 12 12 12 12 12 12 12 12 12 12 23 23 22 22 22 22 22 22 22 22 23 12 12 22 
22 12 12 12 12 12 12 12 12 12 12 22 22 22 22 22 22 22 22 22 22 23 12 12 22 
23 24 24 24 24 24 24 24 24 24 24 23 23 23 23 23 23 23 23 23 23 23 22 22 22 
0 0 0 0 0 0 0 0 0 0 0 0 0 0 0 0 0 0 0 0 0 0 0 0 0 
0 0 0 0 0 0 0 0 0 0 0 0 0 0 0 0 0 0 0 0 0 0 0 0 0 
0 0 0 0 0 0 0 0 0 0 0 0 0 0 0 0 0 0 0 0 0 0 0 0 0 
