22
21
22 22 22 22 22 22 22 22 22 22 22 22 22 22 22 22 22 22 22 22 22 23 
22 12 12 12 12 12 12 12 12 12 12 12 12 12 12 12 12 12 12 12 22 23 
22 12 12 12 12 12 12 12 12 12 12 12 12 12 12 12 12 12 12 12 22 23 
22 12 12 12 12 12 12 12 12 12 12 12 12 12 12 12 12 12 12 12 22 23 
22 12 12 12 12 12 12 12 12 12 12 12 12 12 12 12 12 12 12 12 22 23 
22 12 12 12 12 12 12 12 12 12 12 12 12 12 12 12 12 12 12 12 22 23 
22 12 12 12 12 12 12 12 12 12 12 12 12 12 12 12 12 12 12 12 22 23 
22 12 12 12 12 12 12 12 12 12 12 12 12 12 12 12 12 12 12 12 22 23 
22 12 12 12 12 12 12 12 12 12 12 12 12 12 12 12 12 12 12 12 22 23 
22 12 12 12 12 12 12 12 12 12 12 12 12 12 12 12 12 12 12 12 22 23 
22 12 12 12 12 12 12 12 12 12 12 12 12 12 12 12 12 12 12 12 22 23 
22 12 12 12 12 12 12 12 12 12 12 12 12 12 12 12 12 12 12 12 22 23 
22 12 12 12 12 12 12 12 12 12 12 12 12 12 12 12 12 12 12 12 22 23 
22 12 12 12 12 12 12 12 12 12 12 12 12 12 12 12 12 12 12 12 22 23 
22 12 12 12 12 12 12 12 12 12 12 12 12 12 12 12 12 12 12 12 22 23 
22 12 12 12 12 12 12 12 12 12 12 12 12 12 12 12 12 12 12 12 22 23 
22 12 12 12 12 12 12 12 12 12 12 12 12 12 12 12 12 12 12 12 22 23 
22 24 24 24 24 24 24 24 24 24 24 24 24 24 24 24 24 24 24 24 22 23 
0 0 0 0 0 0 0 0 0 0 0 0 0 0 0 0 0 0 0 0 0 0 
0 0 0 0 0 0 0 0 0 0 0 0 0 0 0 0 0 0 0 0 0 0 
0 0 0 0 0 0 0 0 0 0 0 0 0 0 0 0 0 0 0 0 0 0 
